###############
# @   C   C  %#
####CCC# C ####
# % ### C #CC #
#    #  C %#C #
# ##C C  ##   #
#C # ###  ## C#
#  C#C#&      #
# %   X#C % #C#
###############
